GGGGGGGGGG
GSSSSSSSSG
GSWWWWWWSG
GSWWDDWWSG
GSWWDDWWSG
GSWWDDWWSG
GSWWWWWWSG
GSSSSSSSSG
GGGGGGGGGG
RRRRRRRRRR